32 32 32 32 32 32 32 32 32 32 32 32 32 32 32 32 32 32 32 32 32 32 32 32 32 32 32 32 32 32 32 32 32 32 32 32 32 32 32 32 32 32 32 32 32 32 32 32 32 32 32 32 32 32 32 32 32 32 32 32 32 32 32 32 32 32 32
32 19 19 19 19 19 19 19 19 19 19 19 19 19 19 19 19 19 19 19 19 19 19 19 19 19 19 19 19 19 19 19 19 19 19 18 19 18 18 19 18 18 18 18 18 18 19 19 19 19 19 19 19 19 19 19 19 19 19 19 19 19 19 19 19 19 32
32 19 19 19 19 19 19 19 19 19 19 19 19 19 18 19 18 19 19 19 18 19 18 19 19 19 18 18 18 19 19 18 18 19 18 19 19 19 19 19 19 19 19 19 19 19 19 18 19 18 19 18 19 18 18 18 19 18 18 18 19 19 19 19 19 19 32
32 19 19 19 19 19 19 19 19 19 19 19 19 19 19 19 19 19 19 19 19 19 19 19 19 19 19 19 19 19 19 19 19 19 19 19 19 19 19 19 19 19 19 19 19 19 19 19 19 19 19 19 19 19 19 19 19 19 19 19 18 18 18 18 18 19 32
32 19 19 19 19 19 19 19 19 19 19 19 19 19 19 19 19 19 19 19 19 19 19 19 19 19 19 19 19 19 19 19 19 19 19 19 19 19 19 19 19 19 19 19 19 19 19 19 19 19 19 19 19 19 19 19 19 19 19 19 19 18 18 18 18 19 32
32 19 19 19 19 19 19 19 19 18 18 19 18 18 19 18 18 18 19 19 18 18 18 18 18 18 18 18 18 18 18 19 18 18 18 18 18 18 18 18 19 18 18 18 18 18 18 18 19 18 18 18 18 18 19 18 18 19 19 19 19 18 18 18 18 19 32
32 19 19 19 19 19 19 19 19 18 18 18 18 18 18 19 19 18 18 18 18 18 18 18 18 18 19 19 18 18 18 19 18 18 18 18 18 18 18 18 18 18 18 18 18 18 18 18 18 18 18 18 18 18 18 18 18 19 19 19 19 19 18 18 18 19 32
32 19 19 19 19 19 19 19 19 19 19 19 28 26 26 26 26 26 26 26 26 26 26 26 26 26 26 26 26 26 26 26 26 26 26 26 26 26 26 26 26 26 26 26 26 26 26 26 26 26 26 26 26 26 26 29 18 19 19 19 19 19 18 18 18 19 32
32 19 19 19 19 19 19 19 19 19 19 28 22 2 2 2 2 2 2 8 3 3 3 3 3 3 3 3 3 3 3 7 2 2 8 3 3 3 3 3 3 3 17 17 17 17 17 17 17 17 17 17 17 17 17 23 18 19 19 19 19 19 18 18 19 19 32
32 19 19 19 19 19 19 19 19 19 19 24 20 21 21 21 21 22 2 8 3 3 3 3 3 3 3 3 3 3 3 7 2 2 8 3 3 3 3 3 3 3 17 17 17 17 17 17 17 17 17 17 17 17 17 23 18 18 19 19 19 19 19 18 18 19 32
32 19 19 19 19 19 19 19 19 19 19 19 19 19 19 19 19 24 2 8 3 3 3 3 3 3 3 3 3 3 3 7 2 1 8 3 3 66 66 66 66 66 66 66 66 66 17 17 17 17 17 17 17 17 17 23 18 18 19 19 19 19 18 18 18 19 32
32 19 19 19 19 19 19 19 19 19 19 19 19 19 19 19 19 24 2 8 3 3 3 3 3 3 3 3 3 3 3 7 2 1 8 3 3 66 66 66 66 66 66 66 66 66 17 17 17 17 17 17 17 17 17 23 18 18 19 19 19 19 18 18 19 19 32
32 19 19 19 19 19 19 19 19 19 19 19 19 19 19 19 18 24 2 8 3 3 3 3 3 3 3 3 3 3 3 7 2 1 8 3 3 66 66 66 66 66 66 66 66 66 17 17 17 17 17 17 17 17 17 23 18 18 19 19 19 19 18 18 18 19 32
32 19 19 19 19 19 19 19 19 19 19 24 25 26 26 26 26 30 21 21 3 3 3 3 3 3 3 3 3 3 3 7 1 1 8 3 3 3 3 3 3 3 3 3 3 32 17 17 17 17 17 17 17 17 17 23 18 19 19 19 19 19 18 18 18 19 32
32 19 19 19 19 19 19 19 19 19 19 24 3 3 3 3 3 3 3 3 3 3 3 3 3 3 3 3 3 3 3 7 1 2 8 3 3 3 3 3 3 3 3 3 3 32 17 17 17 17 17 17 17 17 17 23 18 19 19 19 19 19 18 18 18 19 32
32 19 19 19 19 19 19 19 19 19 19 24 3 3 3 3 3 3 3 3 3 3 3 3 3 3 3 3 3 3 3 7 1 2 8 3 3 3 4 35 35 35 35 3 3 32 17 17 17 17 17 17 17 17 17 23 18 19 19 19 19 19 18 18 19 19 32
32 19 19 19 19 19 19 19 19 19 19 24 3 3 3 3 3 3 3 3 3 3 3 3 3 3 3 3 3 3 3 7 1 2 8 3 3 3 7 2 2 2 35 35 35 35 35 35 35 35 35 35 35 35 35 23 18 19 19 19 19 19 19 18 18 19 32
32 19 19 19 19 19 19 19 19 19 19 24 3 3 4 5 5 5 5 5 5 5 5 5 5 6 3 3 3 3 4 1 1 12 11 3 3 4 2 16 16 2 2 2 2 2 2 2 2 2 2 2 2 2 2 23 18 19 19 19 19 19 18 18 18 19 32
32 19 19 19 19 19 19 19 19 19 19 24 3 3 7 2 2 2 2 2 2 2 2 2 2 14 5 5 5 5 15 1 2 14 6 4 5 15 16 16 16 16 2 2 2 2 2 2 2 2 2 2 2 2 2 23 18 18 19 19 19 19 19 18 18 19 32
32 19 19 19 19 19 19 19 19 19 19 24 3 3 7 2 2 2 2 2 2 2 2 2 2 2 2 1 1 1 1 1 2 2 14 15 2 2 16 16 16 2 2 2 2 2 2 2 1 2 2 2 2 2 2 23 18 18 19 19 19 19 18 18 18 19 32
32 19 19 19 19 19 19 19 19 19 19 24 3 3 7 2 2 2 1 1 1 1 1 1 1 2 1 1 2 2 2 2 2 2 1 1 2 2 1 1 2 2 2 2 2 2 5 5 5 5 5 5 5 2 2 23 18 18 19 19 19 19 18 19 19 19 32
32 19 19 19 19 19 19 19 19 19 19 24 3 3 7 2 2 1 2 2 2 2 1 1 1 1 2 2 2 2 2 2 2 2 1 1 2 2 1 1 1 2 2 2 2 2 1 2 2 1 1 2 2 2 2 23 18 18 19 19 19 19 19 19 19 19 32
32 19 19 19 19 19 19 19 19 19 19 24 3 3 7 2 2 2 13 2 2 2 1 2 1 1 1 2 2 2 16 16 16 16 2 2 1 1 1 1 1 2 1 2 1 1 2 1 1 1 1 2 2 2 2 23 18 18 19 19 19 19 19 19 19 19 32
32 19 19 19 19 19 19 19 19 19 19 24 3 3 7 2 2 1 1 2 2 2 2 2 1 2 1 2 2 2 16 16 16 16 2 2 1 2 1 1 1 2 1 1 2 2 1 1 2 1 2 2 1 2 2 23 18 19 19 19 19 19 19 19 19 19 32
32 19 19 19 19 19 19 19 19 19 19 24 3 3 7 2 2 1 2 2 2 2 2 2 1 1 2 1 2 2 2 2 2 2 2 2 1 1 1 1 2 1 2 2 1 1 1 2 2 1 1 1 1 1 2 23 18 19 19 19 19 19 19 19 19 19 32
32 19 19 19 19 19 19 19 19 19 19 24 3 3 7 2 2 2 2 1 2 1 2 1 1 1 1 1 1 2 2 1 1 1 2 1 1 1 2 2 1 1 1 1 2 12 13 1 2 1 1 2 1 1 2 23 18 18 19 19 19 19 19 19 19 19 32
32 19 19 19 19 19 19 19 19 19 19 24 3 3 7 2 2 1 2 1 2 1 2 1 1 1 1 1 1 1 1 2 2 2 2 2 2 2 2 1 1 2 1 1 1 8 7 1 1 1 1 1 1 1 2 23 18 18 19 19 19 19 19 19 19 19 32
32 19 19 19 19 19 19 19 19 19 19 24 3 3 7 2 2 1 2 2 1 2 7 2 1 2 1 1 1 1 2 2 1 1 1 2 2 1 1 2 1 1 1 1 1 8 7 1 1 1 1 1 2 1 2 23 18 19 19 19 19 19 19 19 19 19 32
32 19 19 19 19 19 19 19 19 19 19 24 3 3 7 2 2 1 2 2 2 1 1 1 1 1 2 2 1 2 1 1 16 2 12 13 2 1 1 2 2 2 1 2 1 8 7 1 1 2 1 1 2 1 2 23 18 19 19 19 19 19 19 19 19 19 32
32 19 19 19 19 19 19 19 19 19 19 24 3 3 7 2 2 2 2 2 2 2 2 2 2 15 2 1 1 1 1 1 2 2 14 15 2 2 16 16 16 2 2 2 2 8 7 2 1 2 2 2 2 2 2 23 18 18 19 19 19 19 19 19 19 19 32
32 19 19 19 19 19 19 19 19 19 19 24 3 3 7 2 2 13 1 1 1 1 1 1 1 2 1 1 2 2 2 2 2 2 1 1 2 2 1 1 2 2 2 2 2 8 7 1 1 1 2 2 2 2 2 23 18 18 19 19 19 19 19 19 19 19 32
32 19 19 19 19 19 19 19 19 19 19 24 3 3 7 2 2 1 2 2 2 2 1 1 1 1 2 2 2 2 2 2 2 2 1 1 2 2 1 1 1 2 2 2 2 8 7 2 2 1 1 2 2 2 2 23 18 18 19 19 19 19 19 19 19 19 32
32 19 19 19 19 19 19 19 19 19 19 24 3 3 7 2 2 2 2 2 2 2 1 12 13 1 1 2 2 2 16 16 16 16 2 2 1 1 1 1 1 2 1 2 1 14 15 1 1 1 1 2 2 2 2 23 18 18 19 19 19 19 19 19 19 19 32
32 19 19 19 19 19 19 19 19 19 19 24 3 3 7 2 2 1 1 2 12 10 10 11 7 2 1 2 2 2 16 16 16 16 2 2 1 2 1 1 1 2 1 1 2 2 1 1 2 1 2 2 1 2 2 23 18 19 19 19 19 19 19 19 19 19 32
32 19 19 19 19 19 19 19 19 19 19 24 3 3 7 2 2 1 2 2 14 5 5 6 7 1 2 1 2 2 2 2 2 2 2 2 1 1 1 1 2 1 2 2 1 1 1 2 2 1 1 1 1 1 2 23 18 19 19 19 19 19 19 19 19 19 32
32 19 19 19 19 19 19 19 19 19 19 24 3 3 7 2 2 2 2 1 2 1 2 8 9 13 1 1 1 2 2 1 1 1 2 1 1 1 2 2 1 1 1 1 2 1 1 1 2 1 1 2 1 1 2 23 18 18 19 19 19 19 19 19 19 19 32
32 19 19 19 19 19 19 19 19 19 19 24 3 3 7 2 2 1 2 1 2 1 12 11 3 7 1 1 1 1 1 2 2 2 2 2 2 2 2 1 1 2 1 1 1 1 1 1 1 1 1 1 1 1 2 23 18 18 19 19 19 19 19 19 19 18 32
32 19 19 19 19 19 19 19 19 19 19 24 3 3 7 2 2 1 2 2 1 2 14 6 9 13 1 1 1 1 2 2 1 1 1 2 2 1 1 2 1 1 1 1 1 1 2 1 1 1 1 1 2 1 2 23 18 19 19 19 19 19 19 19 19 19 32
32 19 19 19 19 19 19 19 19 19 19 24 3 3 7 2 2 1 2 2 2 1 1 14 5 15 2 2 1 2 1 1 16 2 1 1 2 1 1 2 2 2 1 2 1 1 1 1 1 2 1 1 2 1 2 23 18 19 19 19 19 19 19 19 19 19 32
32 19 19 19 19 19 19 19 19 19 19 24 3 3 7 2 2 1 2 2 1 2 1 2 1 2 1 1 1 1 1 1 16 1 1 1 1 1 2 1 1 1 2 2 2 1 1 2 2 2 1 2 1 1 2 23 18 19 19 19 19 19 19 19 19 19 32
32 19 19 19 19 19 19 19 19 19 19 24 3 3 7 2 2 1 2 1 2 1 1 1 1 2 2 1 1 1 16 16 16 1 1 1 1 1 1 1 1 2 2 1 2 1 1 2 1 2 2 1 1 2 2 23 18 19 19 19 19 19 19 19 19 19 32
32 19 19 19 19 19 19 19 19 19 19 24 3 3 7 2 2 1 1 1 1 1 2 1 1 2 1 2 2 1 2 1 16 1 2 2 1 1 1 1 1 2 2 2 1 1 1 2 2 1 1 1 2 2 2 23 18 19 19 19 19 19 19 19 19 19 32
32 19 19 19 19 19 19 19 19 19 19 24 3 3 7 2 2 2 1 1 1 2 2 2 1 2 1 2 2 2 1 1 16 16 2 1 1 1 2 1 2 2 1 1 1 2 1 1 1 2 2 2 1 2 2 23 18 19 19 19 19 19 19 19 19 19 32
32 19 19 19 19 19 19 19 19 19 19 24 3 3 7 2 2 1 1 1 2 2 1 2 2 2 1 1 2 2 1 1 16 16 16 1 1 2 2 2 1 1 2 2 1 2 1 1 1 1 2 2 1 1 2 23 18 19 19 19 19 19 19 19 19 19 32
32 19 19 19 19 19 19 19 19 19 19 24 3 3 7 2 2 1 1 1 2 1 1 2 2 1 1 2 1 1 1 1 1 1 1 1 1 1 2 2 1 1 1 2 2 1 1 1 2 1 1 1 1 1 2 23 18 19 19 19 19 19 19 19 19 19 32
32 19 19 19 19 19 19 19 19 19 19 24 3 3 7 2 2 1 2 1 1 1 1 2 1 1 1 1 2 1 2 2 1 1 1 1 2 1 1 1 1 2 1 20 21 21 21 22 2 1 1 1 1 1 2 23 18 19 19 19 19 18 18 18 19 19 32
32 19 19 19 19 19 19 19 19 19 19 24 3 3 7 2 2 1 2 1 1 1 1 1 1 2 2 2 1 1 1 1 1 1 1 1 1 1 2 1 2 1 2 23 19 18 18 24 1 1 1 1 1 2 2 23 19 19 19 19 19 18 18 18 19 19 32
32 19 19 19 19 19 19 19 19 19 19 24 3 3 7 2 2 1 1 2 2 1 1 1 1 1 1 2 2 2 2 2 2 1 1 2 2 1 1 1 1 1 1 23 19 19 18 24 1 2 1 1 1 2 2 23 18 19 19 19 19 18 18 18 19 19 32
32 19 19 19 19 19 19 19 19 19 19 24 3 3 7 2 2 2 1 2 2 2 1 1 1 2 1 1 1 2 2 2 2 2 2 2 1 1 1 1 1 2 2 23 19 19 18 24 1 2 2 1 1 2 2 23 18 19 19 19 19 19 18 18 19 19 32
32 19 19 19 19 19 19 19 19 18 19 24 3 3 7 2 2 2 1 2 2 1 2 2 2 1 1 2 2 1 1 2 2 2 2 1 1 2 2 2 1 2 2 25 26 26 26 27 2 2 1 1 1 1 2 23 18 18 19 19 19 19 18 19 18 19 32
32 19 19 19 19 19 19 19 19 18 19 24 3 3 7 2 12 13 1 2 2 1 1 1 2 1 1 2 2 2 1 2 2 1 1 1 2 2 2 1 1 2 2 1 2 1 2 2 2 2 1 1 2 2 1 23 18 18 19 19 19 19 18 19 19 19 32
32 19 19 19 19 19 19 19 19 18 19 24 3 3 7 2 14 15 1 2 2 1 2 1 1 2 2 1 1 1 2 2 2 1 1 1 1 1 2 1 1 1 1 2 1 2 2 2 1 1 2 1 2 2 2 23 18 19 19 19 19 19 18 19 19 19 32
32 19 19 19 19 19 19 19 19 18 19 24 3 3 7 2 2 2 1 2 1 2 2 2 1 1 1 1 2 1 1 1 2 1 2 1 2 1 1 1 1 1 1 1 1 1 1 1 2 1 1 1 2 2 2 23 18 19 19 19 19 19 19 19 19 19 32
32 19 19 19 19 19 19 19 18 18 19 24 3 3 7 2 2 2 1 1 2 1 1 1 1 1 1 1 1 1 1 1 1 1 1 2 1 1 1 1 1 1 1 2 1 1 1 1 1 2 2 1 2 2 2 23 18 19 19 19 19 19 19 19 19 19 32
32 19 19 19 19 19 19 19 18 18 19 24 3 3 7 2 2 2 1 2 1 1 1 1 2 1 1 2 1 2 2 1 1 1 1 2 2 2 1 1 1 1 1 1 2 2 2 1 1 2 2 2 2 2 1 23 18 19 19 19 19 19 19 19 19 19 32
32 19 19 19 19 19 19 19 18 18 19 24 3 3 7 2 2 1 2 2 2 2 2 2 2 2 2 2 1 1 1 1 12 13 2 1 1 1 1 2 1 2 2 1 1 1 1 1 1 2 2 2 2 2 2 23 18 19 19 19 19 19 19 19 19 19 32
32 19 19 19 19 19 19 19 18 18 19 24 3 3 7 2 2 1 1 2 1 1 1 1 1 2 1 2 1 1 2 12 11 9 13 2 2 2 2 2 2 2 2 2 2 2 2 2 2 2 2 2 2 2 2 23 18 19 19 19 19 19 19 19 19 19 32
32 19 19 19 19 19 19 19 18 18 18 24 3 3 7 2 2 2 2 2 2 2 2 2 2 2 2 2 2 2 2 14 5 5 15 2 2 2 2 2 2 2 2 2 2 2 2 2 2 2 2 2 16 16 16 23 18 19 19 19 19 19 19 19 19 19 32
32 19 19 19 19 19 19 19 18 19 18 24 3 3 7 16 2 2 2 2 2 2 2 2 2 2 2 2 2 2 2 2 2 16 16 2 2 2 2 2 2 10 10 10 2 2 2 2 2 2 16 2 16 16 16 23 18 19 19 19 19 19 19 19 19 19 32
32 19 19 19 19 19 19 19 18 18 18 24 3 3 7 16 16 2 2 2 2 2 2 2 2 2 2 2 2 2 2 2 2 16 16 16 2 2 2 2 2 2 2 2 2 2 2 2 2 2 16 16 16 16 16 23 18 19 19 19 19 19 19 19 19 19 32
32 19 19 19 19 19 19 19 18 18 18 24 3 3 7 2 2 2 2 2 2 2 2 2 2 2 2 2 2 2 5 5 5 21 22 2 2 2 2 2 2 2 2 2 2 2 2 2 2 2 2 2 16 16 16 23 18 19 19 19 19 19 19 19 19 19 32
32 19 19 19 19 19 19 19 18 18 18 30 21 21 21 21 21 21 21 21 21 21 21 21 21 21 21 21 21 21 21 21 21 30 21 21 21 21 21 21 21 21 21 21 21 21 21 21 21 21 21 21 21 21 21 31 18 18 19 19 19 19 19 19 19 19 32
32 19 19 19 19 19 19 19 18 18 18 18 18 18 18 18 18 18 18 18 18 18 18 18 18 18 18 18 18 18 19 18 18 18 18 18 18 18 18 18 18 18 18 18 18 18 19 19 18 18 18 18 18 18 18 18 18 19 19 19 19 19 19 19 19 19 32
32 19 19 19 19 19 19 19 18 19 18 18 18 18 19 19 19 19 18 18 18 18 18 19 19 18 18 18 18 19 19 19 19 18 18 18 18 18 18 18 18 18 18 18 18 18 18 18 18 19 19 19 19 19 19 19 19 19 19 19 19 19 19 19 19 19 32
32 19 19 19 19 19 19 19 18 19 18 18 18 18 19 19 19 19 18 18 18 18 18 19 19 18 18 18 18 19 19 19 19 18 18 18 18 18 18 18 18 18 18 18 18 18 18 18 18 19 19 19 19 19 19 19 19 19 19 19 19 19 19 19 19 19 32
32 19 19 19 19 19 19 19 18 19 18 18 18 18 19 19 19 19 18 18 18 18 18 19 19 18 18 18 18 19 19 19 19 18 18 18 18 18 18 18 18 18 18 18 18 18 18 18 18 19 19 19 19 19 19 19 19 19 19 19 19 19 19 19 19 19 32
32 32 32 32 32 32 32 32 32 32 32 32 32 32 32 32 32 32 32 32 32 32 32 32 32 32 32 32 32 32 32 32 32 32 32 32 32 32 32 32 32 32 32 32 32 32 32 32 32 32 32 32 32 32 32 32 32 32 32 32 32 32 32 32 32 32 32
